1 1 1 1 1 1 1 1 1 1 1 1 7 7 7 7 7 7 7 7
1 1 1 8 1 8 8 1 1 1 1 1 7 7 7 7 7 7 7 7
1 8 1 1 1 8 1 1 1 6 6 2 1 6 6 1 F F 1 8
1 1 6 6 6 1 1 1 1 6 6 2 1 1 1 1 1 1 8 8
1 1 6 1 1 1 1 1 1 6 6 1 1 1 1 1 1 8 8 8
1 1 1 1 1 1 1 1 1 7 7 7 1 8 8 8 8 8 8 3
1 1 1 8 8 8 8 8 8 8 7 7 8 3 3 3 3 3 3 3
8 8 8 3 3 3 3 3 3 3 7 7 3 3 3 3 3 3 3 3
8 8 3 3 3 3 3 3 3 3 7 7 3 8 8 8 8 8 8 8
3 3 3 3 1 8 8 8 1 7 7 7 7 1 1 6 6 6 8 8
3 3 8 8 1 1 1 1 1 7 7 7 7 1 1 6 6 6 8 8
3 3 1 1 1 1 1 1 1 1 1 2 8 8 8 6 6 6 1 8
8 8 1 4 4 4 4 1 1 1 1 2 8 8 8 1 1 1 1 8
1 1 1 4 4 4 4 1 1 1 1 2 2 2 1 1 1 1 1 8
1 1 1 4 4 4 4 1 1 1 1 1 1 1 1 1 1 1 1 8
1 1 1 4 4 4 4 1 1 1 1 1 1 1 1 2 2 2 1 8
1 1 1 1 1 1 1 1 1 1 1 1 1 1 1 2 6 6 1 8
1 1 1 1 1 1 1 1 1 1 1 1 1 1 1 2 6 6 8 8
1 1 1 1 1 1 1 1 1 1 1 1 1 1 1 1 1 8 8 8
1 1 1 1 1 1 1 1 1 1 1 1 1 1 1 1 1 8 8 8